hair bow	发饰蝴蝶结		
hair ribbon	发带		
hairband	发箍		
headband	头带		
forehead protector	额头保护带		
sweatband	汗带		
cardigan	开衫		
cardigan vest	马甲式开衫		
coat	外套		
duffel coat	达菲大衣		
fur coat	皮草大衣		
fur-trimmed coat	皮草镶边大衣		
long coat	长大衣		
overcoat	大衣		
peacoat	双排扣大衣		
raincoat	雨衣		
yellow raincoat	黄色雨衣		
transparent raincoat	透明雨衣		
trench coat	风衣		
winter coat	冬季大衣		
compression shirt	压缩衬衫		
corset	紧身胸衣		
dress (see tag group:dress)	连衣裙（见标签组：连衣裙）		
halterneck	挂脖领		
criss-cross halter	交叉式挂脖		
halterneck	露背装		
hoodie	连帽衫		
jacket	夹克		
blazer	西装外套		
cropped jacket (bolero)	短款夹克（玻璃罗）		
letterman jacket	校队夹克		
safari jacket	狩猎夹克		
suit jacket	西装上衣		
sukajan	日式绣花夹克		
trench coat	风衣		
poncho	斗篷		
raglan sleeves (see tag group:sleeves)	拉根袖（见标签组：袖子）		
sash	腰带		
shoulder sash	肩腰带		
stole	披肩		
shirt	衬衫		
collared shirt	带领衬衫		
dress shirt	正式衬衫		
off-shoulder shirt	露肩衬衫		
sleeveless shirt	无袖衬衫			
tabard	外套		