Headwear and Headgear	头饰与头巾				
balaclava	巴拉克拉法帽		
crown	皇冠		
hair bow	发饰蝴蝶结		
hair ribbon	发带		
hairband	发箍		
headband	头带		
forehead protector	额头保护带		
sweatband	汗带		
hachimaki	日式头巾		
mongkhon	泰拳头带		
headdress	头饰		
maid headdress	女仆头饰		
tiara	冠冕		
veil	面纱		
honggaitou	宽边帽		
Shirts and Topwear	衬衫与上衣		
blouse	女式衬衫		
frilled shirt	荷叶边衬衫		
sleeveless shirt	无袖衬衫		
bustier	紧身胸衣		
crop top	短款上衣		
camisole	吊带衫		
cardigan	开衫		
cardigan vest	马甲式开衫		
coat	外套		
duffel coat	达菲大衣		
fur coat	皮草大衣		
fur-trimmed coat	皮草镶边大衣		
long coat	长大衣		
overcoat	大衣		
peacoat	双排扣大衣		
raincoat	雨衣		
yellow raincoat	黄色雨衣		
transparent raincoat	透明雨衣		
trench coat	风衣		
winter coat	冬季大衣		
compression shirt	压缩衬衫		
corset	紧身胸衣		
dress (see tag group:dress)	连衣裙（见标签组：连衣裙）		
halterneck	挂脖领		
criss-cross halter	交叉式挂脖		
halterneck	露背装		
hoodie	连帽衫		
jacket	夹克		
blazer	西装外套		
cropped jacket (bolero)	短款夹克（玻璃罗）		
letterman jacket	校队夹克		
safari jacket	狩猎夹克		
suit jacket	西装上衣		
sukajan	日式绣花夹克		
trench coat	风衣		
poncho	斗篷		
raglan sleeves (see tag group:sleeves)	拉根袖（见标签组：袖子）		
sash	腰带		
shoulder sash	肩腰带		
stole	披肩		
shirt	衬衫		
collared shirt	带领衬衫		
dress shirt	正式衬衫		
off-shoulder shirt	露肩衬衫		
sleeveless shirt	无袖衬衫		
striped shirt	条纹衬衫		
t-shirt	T恤		
shrug	短款披肩		
surcoat	外套		
sweater	毛衣		
pullover	套头衫		
turtleneck	高领衫		
sleeveless turtleneck	无袖高领衫		
sweater dress	毛衣裙		
ribbed sweater	羊毛衫		
aran sweater	爱尔兰毛衣		
tabard	外套		
tailcoat	燕尾服		
tank top	背心		
stringer	运动背心		
tube top	管状上衣		
bandeau	束胸		
underbust	下胸衣		
vest	马甲		
sweater vest	毛衣马甲		
waistcoat	背心		
Pants and Bottomwear	裤装和下装		
bloomers	蓬蓬裤		
buruma	运动短裤（日本）		
chaps	牛仔护腿		
kilt	苏格兰裙		
pants	裤子		
bell-bottoms	喇叭裤		
capri pants	卡普里裤		
detached pants	分体裤		
jeans	牛仔裤		
cutoff jeans	剪裁牛仔裤		
lowleg pants	低腰裤		
pants rolled up	卷边裤		
yoga pants	瑜伽裤		
pelvic curtain	腰围布		
petticoat	衬裙		
sarong	沙龙裙		
shorts	短裤		
bike shorts	自行车短裤		
denim shorts	牛仔短裤		
dolphin shorts	海豚短裤		
gym shorts	运动短裤		
lowleg shorts	低腰短裤		
micro shorts	微型短裤		
short shorts	极短裤		
shorts under skirt	裙下短裤		
skirt	裙子		
bubble skirt	泡泡裙		
high-waist skirt	高腰裙		
high-low skirt	高低裙		
long skirt	长裙		
lowleg skirt	低腰裙		
microskirt	微型裙		
miniskirt	迷你裙		
overall skirt	工装裙		
plaid skirt (tartan/kilt skirt)	格子裙（苏格兰/苏格兰裙）		
pleated skirt	百褶裙		
suspender skirt	吊带裙		
Legs and Feet	腿和脚		
See tag group:legwear.	查看标签组：腿部穿着。		
garter belt	吊袜带		
garter straps	吊袜带带子		
legwear garter	腿部穿着吊袜带		
kneehighs	高至膝盖的袜子		
leggings	紧身裤		
leg warmers	护腿		
over-kneehighs	超过膝盖的袜子		
pantyhose	连裤袜		
thighband pantyhose	大腿带连裤袜		
socks	袜子		
ankle socks	短袜		
bobby socks	芭比袜		
loose socks	松散袜		
tabi	足袋		
toe socks	分趾袜		
tube socks	筒袜		
thighhighs	大腿袜		
thigh strap	大腿带		
Shoes and Footwear	鞋和鞋类		
boots	靴子		
ankle boots	短靴		
armored boots	铠甲靴		
cowboy boots	牛仔靴		
spurs	马刺		
knee boots	膝盖靴		
high heel boots	高跟靴		
lace-up boots	系带靴		
rubber boots	橡胶靴		
thigh boots	大腿靴		
work boots	工作靴		
cross-laced footwear	交叉系带鞋		
dress shoes	正装鞋		
flats	平底鞋		
footwear ribbon	鞋带		
high heels	高跟鞋		
loafers	休闲鞋		
kiltie loafers	带流苏的休闲鞋		
mary janes	玛丽珍鞋		
platform footwear	厚底鞋		
pointy footwear	尖头鞋		
pumps	低跟鞋		
sandals	凉鞋		
clog sandals	木屐凉鞋		
cross-laced sandals	交叉系带凉鞋		
flip-flops	人字拖		
gladiator sandals	罗马凉鞋		
geta	下j（日式木屐）		
okobo	高底下j		
waraji	草鞋		
zouri	草履		
oxfords	牛津鞋		
saddle shoes	鞍座鞋		
monk shoes	僧侣鞋		
slippers	拖鞋		
animal slippers	动物拖鞋		
ballet slippers	芭蕾舞鞋		
crocs	洞洞鞋		
uwabaki	上履（日式室内鞋）		
sneakers	运动鞋		
high tops	高帮鞋		
converse	帆布鞋		
toeless footwear	露趾鞋		
uwabaki	上履（重复项）		
winged footwear	带翅膀的鞋		
wedge heels	楔形高跟鞋		
Uniforms and Costumes	制服和服装		
apron	围裙		
armor	盔甲		
armored dress	加固裙装		
bikini armor	比基尼盔甲		
band uniform	乐队制服		
cape	斗篷		
capelet	小斗篷		
hood	头巾		
side cape	侧斗篷		
cassock	教士袍		
cheerleader	啦啦队员		
costume	服装		
ghost costume	鬼魂服装		
formal	正装		
suit	西装		
business suit	商务装		
pant suit	裤装套装		
skirt suit	裙装套装		
tuxedo	礼服		
gym uniform	校服运动装		
buruma	运动短裤（重复项）		
habit	修女服		
harem outfit	哈伦装		
loincloth	丁字裤		
hazmat suit	防化服		
hev suit	高效防护服		
kigurumi	动物连体服		
animal costume	动物装		
bear costume	熊装		
boar costume	野猪装		
cat costume	猫装		
cow costume	牛装		
dog costume	狗装		
monkey costume	猴装		
mouse costume	老鼠装		
panda costume	熊猫装		
penguin costume	企鹅装		
pig costume	猪装		
rabbit costume	兔装		
reindeer costume	驯鹿装		
seal costume	海豹装		
sheep costume	羊装		
tiger costume	老虎装		
maid	女仆		
miko	巫女		
nontraditional miko	非传统巫女		
military uniform	军装		
overalls	工装裤		
pajamas	睡衣		
pilot suit	飞行员服装		
plugsuit	插头服		
sailor (naval uniform)	水手（海军制服）		
santa costume	圣诞老人服装		
school uniform	校服		
serafuku (sailor uniform)	水手服（校服）		
sailor dress	水手裙		
gakuran	学生装（日式）		
meiji schoolgirl uniform	明治时代学生服		
shosei	学生（日式）		
track suit	运动服		
sweatpants	运动裤		
sweater	毛衣		
tutu	芭蕾舞裙		
waitress	服务员		
cowboy western (cowboy outfit)	西部牛仔（牛仔装）		
Swimsuits and Bodysuits	泳装和紧身衣物		
bikesuit	自行车服		
racing suit	赛车服		
bodystocking	全身袜		
bodysuit	紧身衣		
jumpsuit	连体衣		
short jumpsuit	短款连体衣		
leotard	体操服		
see-through leotard	透视体操服		
strapless leotard	无肩带体操服		
playboy bunny	兔女郎		
swimsuit	泳衣		
competition swimsuit	竞赛泳衣		
slingshot swimsuit	弹弓式泳衣		
school swimsuit	学校泳衣		
bikini	比基尼		
leaf bikini	叶子比基尼		
string bikini	绳结比基尼		
micro bikini	微型比基尼		
side-tie bikini bottom	侧系带比基尼底部		
lowleg bikini	低腰比基尼		
thong bikini	丁字比基尼		
venus bikini	维纳斯比基尼		
sports bikini	运动比基尼		
tankini	坦克式比基尼		
criss-cross halter	交叉系带背心		
swim briefs (speedo)	游泳短裤（速比涛）		
jammers	抗拒水裤		
legskin	腿部泳装		
rash guard	防晒泳装		
robe	长袍		
bathrobe	浴袍		
open robe	开襟长袍		
kesa	和尚袈裟		
romper	连体衣裤		
sarong	沙龙裙		
tunic	束腰外衣		
unitard	紧身连体衣		
Traditional Clothing	传统服装		
chinese clothes	中国服饰		
changpao	长袍		
china dress (cheongsam/qipao)	旗袍		
fengguan	凤冠		
hanfu	汉服		
longpao	龙袍		
tangzhuang	唐装		
dirndl	德国民族服饰		
japanese clothes	日本服饰		
fundoshi			
yamakasa	山笠		
geta	下j（木屐）		
hakama	F		
hakama skirt	F裙		
hakama short skirt	短裙F		
hakama pants	F裤		
kimono	和服		
furisode	振袖		
layered kimono	层叠和服		
short kimono	短和服		
uchikake (wedding kimono)	打欤婚礼和服）		
yukata	浴衣		
haori	羽织		
happi	法被		
chanchanko	肚兜		
dotera	道袍		
hanten	半纱		
kimono skirt	和服裙		
miko	巫女（重复项）		
nontraditional miko	非传统巫女（重复项）		
sarashi	绑带		
Midriff sarashi	腹部绑带		
Chest sarashi	胸部绑带		
Budget sarashi	经济型腹带		
Undone sarashi	松散腹带		
straw cape (mino)	稻草斗篷（蓑衣）		
mino boushi	蓑衣帽		
tabi	足袋		
tasuki	z		
korean clothes	韩式服装		
hanbok	韩服		
vietnamese dress	越南服装		
Jewelry and Accessories	珠宝和配饰		
Head and Face	头部和面部		
earrings	耳环		
hoop earrings	圆环耳环		
stud earrings	钉耳环		
earclip	耳夹		
glasses (see tag group:eyewear)	眼镜		
monocle	单片眼镜		
hair ornament	发饰		
hair beads	发珠		
hair bobbles	发圈		
hairclip	发夹		
hairpin	发簪		
hair scrunchie	发圈		
hair stick	发簪		
kanzashi	簪子		
mask	面具		
plague doctor mask	瘟疫医生面具		
surgical mask	医用口罩		
Neck and Shoulders	颈部和肩部		
See tag group:neck and neckwear.	查看标签组：颈部和肩部。		
ascot	阿斯科特领巾		
bowtie	蝴蝶结领带		
choker	紧颈项链		
collar	领子		
cross tie	十字领带		
epaulettes	肩章		
feather boa	羽毛围巾		
lapels	翻领		
lapel pin	翻领别针		
neck ruff	脖围		
neckerchief	颈巾		
necklace	项链		
necktie	领带		
tie clip	领带夹		
neck ribbon	颈带		
scarf	围巾		
shawl	披肩		
stole	披肩		
Limbs	四肢配饰		
anklet	脚链		
arm belt	臂带		
armband	臂章		
armlet	臂环		
bracelet	手镯		
bangle	手镯		
spiked bracelet	尖刺手镯		
bridal gauntlets	新娘手套		
detached sleeves	分离袖子		
arm warmers	臂套		
fingernails	指甲		
gloves	手套		
boxing gloves	拳击手套		
elbow gloves	长手套		
fingerless gloves	无指手套		
bridal gauntlets	新娘手甲		
spiked gloves	带刺手套		
yugake	弓手套（日式）		
mittens	连指手套		
leg belt	腿带		
ring	戒指		
claw ring	爪型戒指		
wedding ring	结婚戒指		
thighlet	大腿带		
wide sleeves	宽袖		
wristband	手腕带		
wrist cuffs	手腕袖口		
wrist scrunchie	手腕皱褶带		
Torso and Misc	躯干及其他配件		
aiguillette	军装肩绳		
badge	徽章		
belly chain	腹链		
belt	腰带		
buckle	扣子		
belt chain	腰链		
sam browne belt	萨姆布朗腰带		
boutonniere	胸花		
brooch	胸针		
buttons	纽扣		
large buttons	大号纽扣		
button badge	纽扣徽章		
buttoned cuffs	纽扣袖口		
collar chain	领链		
corsage	手腕花		
cuff links	袖扣		
pentacle	五角星形		
piercing (see tag group:piercings)	穿孔		
sarong	沙龙裙		
sash	腰带		
shoulder sash	肩腰带		
suspenders	吊带		
tassel	流苏		
watch	手表		
pocket watch	口袋表		
zipper	拉链		
Styles and Patterns	风格与图案		
Patterns	图案		
argyle	菱形格		
camouflage	迷彩		
checkered	格子		
floral print	花卉图案		
gingham	格子布		
houndstooth	犬牙纹		
pinstripe pattern	条纹图案		
plaid / tartan	格子/苏格兰格		
polka dot	波点		
striped	条纹		
multicolored stripes	彩色条纹		
double vertical stripe	双竖条纹		
Prints	印花		
animal print	动物图案		
bat print	蝙蝠图案		
bear print	熊图案		
butterfly print	蝴蝶图案		
cow print	奶牛图案		
leopard print	豹纹		
tiger print	虎纹		
snake print	蛇纹		
clover print	三叶草图案		
crescent print	新月图案		
floral print	花卉图案		
rose print	玫瑰图案		
camellia print	山茶花图案		
cherry blossom print	樱花图案		
chrysanthemum print	菊花图案		
lily print	百合图案		
morning glory print	牵牛花图案		
peony print	牡丹图案		
plum blossom print	梅花图案		
spider lily print	彼岸花图案		
sunflower print	向日葵图案		
food print	食物图案		
fruit pattern	水果图案		
apple print	苹果图案		
blueberry print	蓝莓图案		
cherry print	樱桃图案		
kiwi print	猕猴桃图案		
lemon print	柠檬图案		
pineapple print	菠萝图案		
orange print	橙子图案		
strawberry print	草莓图案		
watermelon print	西瓜图案		
leaf print	叶子图案		
maple leaf print	枫叶图案		
moon print	月亮图案		
musical note print	音符图案		
paw print	爪印图案		
petal print	花瓣图案		
piano print	钢琴图案		
sparkle print	闪光图案		
triangle print	三角形图案		
space print	太空图案		
starry sky print	星空图案		
star print	星星图案		
wave print	波浪图案		
wing print	翅膀图案		
Other	其他		
clothing cutout	衣服镂空		
dress flower	裙上花纹		
flower trim	花边装饰		
frills	褶边		
fur trim	毛皮边		
gathers	聚拢装饰		
gold trim	金色边条		
lace trim	蕾丝边		
ribbon trim	缎带装饰		
see-through	透视		
silver trim	银色边条		
taut shirt	紧身衬衫		
torn clothes	破损衣物		
See also	另见		
casual	休闲		
cosplay	角色扮演		
fashion	时尚		
lolita fashion	洛丽塔时装		
shoes	鞋子		
